XXXXX
X?  XX
X@** X
XX   X
 XX  X
  XX X
   X?X
   XXX