  XXXX
  X  X
XXX* XX
X *  @X
X ??? X
XX*  XX
 X  XX
 XXXX