XXXXXXXX
X  X   X
X   *  X
X *XX XXXXX
XX X? XX  X
 X X?   * X
 X X? XX  X
 X X?XXX XX
 X@   XX  X
 XX *     X
  XXXXXX  X
       XXXX