 XXXXXXX
 X     XXX
XX*XXX   X
X @ *  * X
X ??X * XX
XX??X   X
XXXXXXXXX